+---+-----------------------+
|...|>....................v.|
|.S.|...........F...........|
|...|.......................|
|...|...+---------------+...|
|...|...|===============|...|
|...|...|===============|...|
|...|...|===============|...|
|...|...|===============|...|
|...|...|===============|...|
|...|...|===============|...|
|...|...|===============|...|
|...|...|===============|...|
|...|...|===============|...|
|...|...+---------------+...|
|...|.......................|
|...|^....................<.|
|...|.......................|
|...........................|
|...........................|
|.........+---------........|
|.........|.................|
|.........|.................|
|.........|.................|
|.........|.................|
|.........|....K............|
|.........|.................|
|.........|.................|
+---------+-----------------+


























