+---+-----------------------+
|...|.......................|
|.S.|.>.........F.........v.|
|...|.......................|
|...|...+---------------+...|
|...|...|===============|...|
|...|...|===============|...|
|...|...|===============|...|
|...|...|===============|...|
|...|...|===============|...|
|...|...|===============|...|
|...|...|===============|...|
|...|...|===============|...|
|...|...|===============|...|
|...|...+---------------+...|
|...|.......................|
|...|.^...................<.|
|...+.......................|
|...........................|
|...........................|
|.........+--------+........|
|.........|.................|
|.........|.................|
|.........|.................|
|.........|.................|
|.........|....K............|
|.........|.................|
|.........|.................|
+---------+-----------------+


























