+---+-----------------------+
|...|.+.....................|
|.S.|.>.........F.........v+|
|...|.......................|
|...|...+---------------+...|
|...|...|===============|...|
|...|...|===============|...|
|...|...|===============|...|
|...|...|===============|...|
|...|...|===============|...|
|...|...|===============|...|
|...|...|===============|...|
|...|...|===============|...|
|...|...|===============|...|
|...|...+---------------+...|
|...|.......................|
|...|+^...................<.|
|...|.....................+.|
|...........................|
|...........................|
|.........+---------........|
|.........|.................|
|.........|.................|
|.........|.................|
|.........|.................|
|.........|....K............|
|.........|.................|
|.........|.................|
+---------+-----------------+


























